DDDDDDDDDDDDDDDDDDDDDDDDDDDDDDDDDDDDDDDDDDDDDDDDDDDDDDDDDDDDDDDDDDDDDDDDDDDDDDDDDDDDDDDDDDD-
D-----------------------------------------------------------------------------------------D-
D-------------------X---------------------------------------------------------------------D-
D----------------LGGR---------------------------------------------------------------------D-
D--0-I-----------lBBr---------------------------------------------------------------------D-
DGGGG-------------------------------------------------------------------------------------D-
D--------------------I-0---I--------------------------------------------------------------D-
D--I00-00I------------GGGGG---------------------------------------------------------------D-
D---GGGGG---------------lr----------------------------------------------------------------D-
D-----------------------------------------------------------------------------------------D-
D00--------------------------------I---------I0----------------------0--------------00I---D-
DLGGGGGGGGGGGGGGGGGGGGGGGGGGGGGGGGR-----------LGGGGGGGGGGGGGGGGGGGGGGGGGGGGGGGGGGGGGGR----D-
DlBBBBBBBBBBBBBBBBBBBBBBBBBBBBBBBBBEEEEEEEEEEEBBBBBBBBBBBBBBBBBBBBBBBB----lBBBBBBBBBBBBB--D-
D-------------I0-I---------------------------GG-------------------------------------------D-
D--------------GG-------------------------------------------------------------------------D-
D---GG---------D---------------------------------I0-I-------------------------------------D-
D----D------I------0--------I---------------------GG-I--0-----------------00----------0---D-
D-I0-I-------GGGGGGGGGGGGGGG--------------------------LGGGGGGGGGGGGGGGGGGGGGGGGGGGGGGGGGGRD-
D--GG----------BBBBBBBBBBBB---------------GG----------lBBBBBBBBBBBBBBBBBBBB-------BBBBBBBrD-
D-----------------------------GG----------D-----------------------------------------------D-
D?---------------------------------00-----------------------------------------------------D-
DGGGGGGGGGGGGGGGGGGGGGGGGGGGGGGGGGGGGGGGGGGGGGGGGGGGGGGGGGGGGGGGGGGGGGGGGGGGGGGGGGGGGGGGGGD-
DDDDDDDDDDDDDDDDDDDDDDDDDDDDDDDDDDDDDDDDDDDDDDDDDDDDDDDDDDDDDDDDDDDDDDDDDDDDDDDDDDDDDDDDDDD-