DDDDDDDDDDDDDDDDDDDDDDDDDDDDDDDDDDDDDDDDDDDDDDDDDDDDDDDDDDDDDDDDDDDDDDDDDDDDDDDDDDDDDDDDDDD-
D-----------------------------------------------------------------------------------------D-
D-------------------X---------------------------------------------------------------------D-
D----------------GGGG---------------------------------------------------------------------D-
D--0-I-----------DDDD---------------------------------------------------------------------D-
DGGGG-------------------------------------------------------------------------------------D-
D--------------------I-0---I--------------------------------------------------------------D-
D--I00-00I------------GGGGG---------------------------------------------------------------D-
D---GGGGG---------------DD----------------------------------------------------------------D-
D-----------------------------------------------------------------------------------------D-
D00--------------------------------I---------I0----------------------0--------------00I---D-
DGGGGGGGGGGGGGGGGGGGGGGGGGGGGGGGGGG-----------GGGGGGGGGGGGGGGGGGGGGGGGGGGGGGGGGGGGGGGG----D-
DDDDDDDDDDDDDDDDDDDDDDDDDDDDDDDDDDDDD-----------DDDDDDDDDDDDDDDDDDDDDDDDDDDDDDDDDDDDDDDD--D-
D-------------I0-I---------------------------GG-------------------------------------------D-
D--------------GG-------------------------------------------------------------------------D-
D---GG---------D---------------------------------I0-I-------------------------------------D-
D----D------I------0--------I---------------------GG-I--0-----------------00----------0---D-
D-I0-I-------GGGGGGGGGGGGGGG--------------------------GGGGGGGGGGGGGGGGGGGGGGGGGGGGGGGGGGGGD-
D--GG----------DDDDDDDDDDDD---------------GG----------DDDDDDDDDDDDDDDDDDDDD-------DDDDDDDDD-
D-----------------------------GG----------D-----------------------------------------------D-
D----------------------------------00-----------------------------------------------------D-
GGGGGGGGGGGGGGGGGGGGGGGGGGGGGGGGGGGGGGGGGGGGGGGGGGGGGGGGGGGGGGGGGGGGGGGGGGGGGGGGGGGGGGGGGGD-
DDDDDDDDDDDDDDDDDDDDDDDDDDDDDDDDDDDDDDDDDDDDDDDDDDDDDDDDDDDDDDDDDDDDDDDDDDDDDDDDDDDDDDDDDDD-