------------
-=----------
------------
====-----===
------=-----
------------
---=========
------------
============