DDDDDDDDDDDDDDDDDDDDDDDDDDDDDDDDDDDDDDDDDDDDDDDDDDDDDDDDDDDDDDDDDDDDDDDDDDDDDDDDDDDDDDDDDDD-
D-----------------------------------------------------------------------------------------D-
D-------------------X---------------------------------------------------------------------D-
D--0---000000000-GGGG---------------------------------------------------------------------D-
D--0-------------DDDD---------------------------------------------------------------------D-
DGGGG-------------------------------------------------------------------------------------D-
D------=-=-----------|-0------------------------------------------------------------------D-
D--00000-------------|GGGGG|--------------------------------------------------------------D-
D---GGGGG---------------DD----------------------------------------------------------------D-
D-----------------------------------------------------------------------------------------D-
D0000000----------------------------------------------------------------------------------D-
DGGGGGGGGGGGGGGGGGGGGGGGGGGGGGGGGGG-----------GGGGGGGGGGGGGGGGGGGGGGGGGGGGGGGGGGGGGGGG----D-
DDDDDDDDDDDDDDDDDDDDDDDDDDDDDDDDDDDDD-----------DDDDDDDDDDDDDDDDDDDDDDDDDDDDDDDDDDDDDDDD--D-
D--------------------------------------------GG-------------------------------------------D-
D--------------GG-------------------------------------------------------------------------D-
D---GG---------D--------------------------------------------------------------------------D-
D----D--------------------------------------------GG--------------------------------------D-
D------------GGGGGGGGGGGGGGG--------------------------GGGGGGGGGGGGGGGGGGGGGGGGGGGGGGGGGGGGD-
D--GG----------DDDDDDDDDDDD---------------GG----------DDDDDDDDDDDDDDDDDDDDD-------DDDDDDDDD-
D-----------------------------GG----------D-----------------------------------------------D-
D-----------------------------------------------------------------------------------------D-
GGGGGGGGGGGGGGGGGGGGGGGGGGGGGGGGGGGGGGGGGGGGGGGGGGGGGGGGGGGGGGGGGGGGGGGGGGGGGGGGGGGGGGGGGGD-
DDDDDDDDDDDDDDDDDDDDDDDDDDDDDDDDDDDDDDDDDDDDDDDDDDDDDDDDDDDDDDDDDDDDDDDDDDDDDDDDDDDDDDDDDDD-