DDDDDDDDDDDDDDDDDDDDDDDDDDDDDDDDDDDDDDDDDDDDDDDDDDDDDDDDDDDDDDDDDDDDDDDDDDDDDDDDDDDDDDDDDDD-
D-----------------------------------------------------------------------------------------D-
D-------------------X---------------------------------------------------------------------D-
D----------------LGGR---------------------------------------------------------------------D-
D--0-I-----------lBBr---------------------------------------------------------------------D-
DGGGG-------------------------------------------------------------------------------------D-
D--------------------I-0---I--------------------------------------------------------------D-
D--I00-00I------------LGGGR---------------------------------------------------------------D-
D---LGGGR-------------lBBBr---------------------------------------------------------------D-
D---lBBBr---------------------------------------------------------------------------------D-
D00--------------------------------I---------I0----------------------0--------------00I---D-
DLGGGGGGGGGGGGGGGGGGGGGGGGGGGGGGGGR-----------LGGGGGGGGGGGGGGGGGGGGGGGGGGGGGGGGGGGGGGR----D-
DBBBBBBBBBBBBBBBBBBBBBBBBBBBBBBBBBBGGGGGGGGGGGBBBBBBBBBBBBBBBBBBBBBBBB----lBBBBBBBBBBBGR--D-
D-------------I0-I----------------lBBBBBBBBBBBr-------------------------------------------D-
D--------------LR-------------------------------------------------------------------------D-
D---GG---------E---------------------------------I0-I-------------------------------------D-
D----D------I------0--------I---------------------GG-I--0-----------------00----------0---D-
D-I0-I-------GGGGGGGGGGGGGGG--------------------------LGGGGGGGGGGGGGGGGGGGGGGGGGGGGGGGGGGGD-
D--GG----------DDDDDDDDDDDD---------------GG----------lBBBBBBBBBBBBBBBBBBBr-------lBBBBBBrD-
D-----------------------------GG----------E-----------------------------------------------D-
D?---------------------------------00-----------------------------------------------------D-
DGGGGGGGGGGGGGGGGGGGGGGGGGGGGGGGGGGGGGGGGGGGGGGGGGGGGGGGGGGGGGGGGGGGGGGGGGGGGGGGGGGGGGGGGGD-
DDDDDDDDDDDDDDDDDDDDDDDDDDDDDDDDDDDDDDDDDDDDDDDDDDDDDDDDDDDDDDDDDDDDDDDDDDDDDDDDDDDDDDDDDDD-