DDDDDDDDDDDDDDDDDDDDDDDDDDDDDDDDDDDDDDDDDDDDDDDDDDDDDDDDDDDDDDDDDDDDDDDDDDDDDDDDDDDDDDDDDDD-
D---------------------------DDDDDDDDDDDDD-------------------------------------------------D-
D-----------------------------------------------------------------------------------------D-
D-------I------------0I-------------------------------------------------------------------D-
D--------DDDDDDDDDDDDD-------------------------I0-----------0I----------------------------D-
D-------------------------I----00-------I-------GGGGGGGGGGGGG----------------I----00---?--D-
D-----------------I-0-I----DDDDDDDDDDDDD-------DDDDD---DDD--------------------GGGGGGGGGGGGD-
D------------------DDD--------------------------------------------------------------------D-
D-----------------------------------------------------------------------------------------D-
D-----------------------------------------------------------------------------------------D-
D-------------I-0I------------------------------------------------------------------------D-
D--------------DD-------------------------------------------------------------------------D-
D-----------------------------------------------------------------------------------------D-
D-----------------I---I-------------------------------------------------------------------D-
D------------------DDD--------------------------------------------------------------------D-
D--------------------------I0I------------------------------------------------------------D-
D---------------------------D-------------------------------------------------------------D-
D--------GGGGGG-----------------------------I-00----------I-------------------------------D-
D--------DDDDDD-----------------------------GGGGGGGGGGGGG---------------------------------D-
D--------D--------------------------------------------------------------------------------D-
D-X------D---------0----------------------------------------------------------------------D-
DGGGGGGGGGGGGGGGGGGGGGGGGGGGGGGGGGGGGGGGGGGGGGGGGGGGGGGGGGGGGGGGGGGGGGGGGGGGGGGGGGGGGGGGGGD-
DDDDDDDDDDDDDDDDDDDDDDDDDDDDDDDDDDDDDDDDDDDDDDDDDDDDDDDDDDDDDDDDDDDDDDDDDDDDDDDDDDDDDDDDDDD-