DDDDDDDDDDDDDDDDDDDDDDDDDDDDDDDDDDDDDDDDDDDDDDDDDDDDDDDDDDDDDDDDDDDDDDDDDDDDDDDDDDDDDDDDDDD-
D-----------------------------------------------------------------------------------------D-
D-----------------------------------------------------------------------------------------D-
D-----------------------------------------------------------------------------------------D-
D-----------------------------------------------------------------------------------------D-
D-----------------------------------------------------------------------------------------D-
D-----------------------------------------------------------------------------------------D-
D-----------------------------------------------------------------------------------------D-
D-----------------------------------------------------------------------------------------D-
D-----------------------------------------------------------------------------------------D-
D-----------------------------------------------------------------------------------------D-
D-----------------------------------------------------------------------------------------D-
D-----------------------------------------------------------------------------------------D-
D-----------------------------------------------------------------------------------------D-
D-----------------------------------------------------------------------------------------D-
D--------------------------I0I------------------------------------------------------------D-
D---------------------------D-------------------------------------------------------------D-
D--------GGGGGG-----------------------------I-00----------I-------------------------------D-
D--------DDDDDD-----------------------------GGGGGGGGGGGGG---------------------------------D-
D--------D--------------------------------------------------------------------------------D-
D-X------D---------0----------------------------------------------------------------------D-
GGGGGGGGGGGGGGGGGGGGGGGGGGGGGGGGGGGGGGGGGGGGGGGGGGGGGGGGGGGGGGGGGGGGGGGGGGGGGGGGGGGGGGGGGGD-
DDDDDDDDDDDDDDDDDDDDDDDDDDDDDDDDDDDDDDDDDDDDDDDDDDDDDDDDDDDDDDDDDDDDDDDDDDDDDDDDDDDDDDDDDDD-