DDDDDDDDDDDDDDDDDDDDDDDDDDDDDDDDDDDDDDDDDDDDDDDDDDDDDDDDDDDDDDDDDDDDDDDDDDDDDDDDDDDDDDDDDDD-
D-----------------------------------------------------------------------------------------D-
D-----------------------------------------------------------------------------------------D-
D-----------------------------------------------------------------------------------------D-
D-----------------------------------------------------------------------------------------D-
D-----------------------------------------------------------------------------------------D-
D-----------------------------------------------------------------------------------------D-
D-----------------------------------------------------------------------------------------D-
D-----------------------------------------------------------------------------------------D-
D-----------------------------------------------------------------------------------------D-
D-----------------------------------------------------------------------------------------D-
D-----------------------------------------------------------------------------------------D-
D-------------------------I----00-------I-------------------------------------------------D-
D--------------------------DDDDDDDDDDDDD--------------------------------------------------D-
D-----------------------------------------------------------------------------------------D-
D--------GGGGGGG-----------I0I------------------------------------------------------------D-
D--------DDDDDDD------------D-------------------------------------------------------------D-
D--------D----------------------------------I-00----------I-------------------------------D-
D--------D----------------------------------GGGGGGGGGGGGG---------------------------------D-
D--------D--------------------------------------------------------------------------------D-
D-X------D---------0------------------------------------------------------000000000-------D-
GGGGGGGGGGGGGGGGGGGGGGGGGGGGGGGGGGGGGGGGGGGGGGGGGGGGGGGGGGGGGGGGGGGGGGGGGGGGGGGGGGGGGGGGGGD-
DDDDDDDDDDDDDDDDDDDDDDDDDDDDDDDDDDDDDDDDDDDDDDDDDDDDDDDDDDDDDDDDDDDDDDDDDDDDDDDDDDDDDDDDDDD-