DDDDDDDDDDDDDDDDDDDDDDDDDDDDDDDDDDDDDDDDDDDDDDDDDDDDDDDDDDDDDDDDDDDDDDDDDDDDDDDDDDDDDDDDDDD-
D-----------------------------------------------------------------------------------------D-
D-----------------------------------------------------------------------------------------D-
D-----------------------------------------------------------------------------------------D-
D-----------------------------------------------------------------------------------------D-
D-----------------------------------------------------------------------------------------D-
D----------------------------------------------------------------DDDDDDDDDDDDD------------D-
D------------------------------------------------------------DD---------------------------D-
D--------GGGGGGGGGGGGG-----------------GGGGGGGGG-------DD---------------------------------D-
D--------DDDDDDDDDDDDD--------------------------------------------------------------------D-
D-----------------------------------------------------------------------------------------D-
D-----------------------------------------------------------------------------------------D-
D-------------------------I----00-------I-------GGGGGGGGGGGGG----------------------------?D-
D--------------------------DDDDDDDDDDDDD-------DDDDD---DDD--------------------GGGGGGGGGGGGD-
D-----------------------------------------------------------------DDDD----------DDDDDDDD--D-
D--------GGGGGGG-----------I0I------------------------------------------------------------D-
D--------DDDDDDD------------D-------------------------------------------------------------D-
D--------D----------------------------------I-00----------I-------------------------------D-
D--------D----------------------------------GGGGGGGGGGGGG---------------------------------D-
D--------D--------------------------------------------------------------------------------D-
D-X------D---------0------------------------------------------------------000000000-------D-
DGGGGGGGGGGGGGGGGGGGGGGGGGGGGGGGGGGGGGGGGGGGGGGGGGGGGGGGGGGGGGGGGGGGGGGGGGGGGGGGGGGGGGGGGGD-
DDDDDDDDDDDDDDDDDDDDDDDDDDDDDDDDDDDDDDDDDDDDDDDDDDDDDDDDDDDDDDDDDDDDDDDDDDDDDDDDDDDDDDDDDDD-